000000000000
111111111111
111111111111
111111111111
111111111111
111111111121
000000000000
